0 0 
# # # # # # # # # # # # 
# . . . . . . . . . . # 
# . . . . . . . . . . # 
# . . . . . . . . . . # 
# . . . . . . . . . . # 
# @ . . . . . . . . X # 
# . . . . . . . . . . # 
# . . . . . . . . . . # 
# . . . . . . . . . . # 
# . . . . . . . . . . # 
# . . . . . . . . . . # 
# # # # # # # # # # # # 
