0 1 
# # # # # # # # 
# . . . # # * # 
# . # . . . . # 
# . . # # # # # 
# # . # . . . # 
# # . # . # ~ # 
# @ . . . # X # 
# # # # # # # # 
