1 0 
# # # # # # # # 
# . . . . . . # 
# . 0 . . . . # 
# . @ . . . $ # 
# . . . . . . # 
# # # D # # # # 
# . . . . X . # 
# # # # # # # # 
