1 2 
# # # # # # # # # # # # 
# . . . . # X # . . . # 
# . . . . # ~ # . . . # 
# . . . . * . . . . . # 
# . . . . . @ . . . . # 
# . . # # # # # # . . # 
# . . # . . $ . # . . # 
# . . # . . . . # . . # 
# . . # . * . . # . . # 
# . . # # # # # # . . # 
# . . . . . . . . . . # 
# # # # # # # # # # # # 
