1 0 
# # # # # 
# @ . + # 
# # - # # 
# . . . # 
# # X # # 
