# # # # # # # # # # 
# @ . . . . . . . # 
# . . . . . . . . # 
# . . . . . . . . # 
# . . . & . . . . # 
# . . . . . . . . # 
# . . . . . . . . # 
# . . . . X . . . # 
# . . . . . . . . # 
# # # # # # # # # # 
