# # # # # # # #
# @ . # . . . #
# # . . . # . #
# # # # . # . #
# X . # . # . #
# # . # # # . #
# # . . . . . #
# # # # # # # #