# # # # # 
# . @ . # 
# . . . # 
# . X 0 # 
# # # # # 
