# # # # # # # # # #
# @ . . . . . . . #
# . . . . . . . . #
# - . . . . . . . #
# . . . . . . . . #
# . . . . . . . | #
# # # # # X # # # #