# # # # # 
# @ . . # 
# . 0 . # 
# . . X # 
# # # # # 
