# # # # # # # # # # 
# @ # . . . . . . # 
# . # . # # # # . # 
# . # . # X . # . # 
# . # . # # . # . # 
# . # . # # . # . # 
# . # . . . . # . # 
# . # # # # # # . # 
# . . . . . . . . # 
# # # # # # # # # # 
